10 10
.....#...#
.....#...#
....SS...#
.....#...#
.....#...#
.....#...#
.....#####
.....#...#
....##.#.#
......S..E
1 1
3
1 2
2 6
9 1
