10 10
##########
#...ES...#
#..#.#...#
#.#...#..#
#........#
#.#..S#..#
#..#.#...#
#........#
###...####
##########
4 4
4
1 2
3 4
2 7
7 7
