11 11
###########
#S...E...S#
#.........#
#.........#
#.........#
#S.......S#
#.........#
#.........#
#.........#
#S...S...S#
###########
5 5
7
4 4
4 6
5 4
5 6
6 4
6 5
6 6
