10 11
###########
#S...S#...#
#.#..##.#.#
#.#..#..#E#
#.#.#..####
#...#.##..#
###...#...#
#.#.......#
#....#.#..#
###########
7 1
2
2 4
7 8
